{
  "rows": 20,
  "cols": 13,
  "ballSpeed": 6.0,
  "paddleWidth": 100,
  "brickWidth": 60,
  "brickHeight": 25,
  "layout": [
    "-------------",
    "-------------",
    "--222222222--",
    "--224---422--",
    "--22-4-4-22--",
    "--22--4--22--",
    "--22-4-4-22--",
    "--224---422--",
    "--222222222--",
    "-00000000000-",
    "-------------",
    "-------------",
    "-------------",
    "-------------",
    "-------------",
    "-------------",
    "-------------",
    "-------------",
    "-------------",
    "-------------"
  ]
}
