{
  "rows": 20,
  "cols": 20,
  "ballSpeed": 6.0,
  "paddleWidth": 100,
  "brickWidth": 39,
  "brickHeight": 25,
  "layout": [
    "---------44---------",
    "--------2222--------",
    "-------211112-------",
    "------22333322------",
    "-----1222222221-----",
    "----033333333330----",
    "---11222222222211---",
    "--1222333333333221--",
    "-001122222222221100-",
    "00001111111111110000",
    "00003330000003330000",
    "--------------------",
    "----122221122221----",
    "---01111111111110---",
    "---01111100111110---",
    "----011111111110----",
    "-----0222222220-----",
    "-----0200000020-----",
    "----003322223300--",
    "--------------------"
  ]
}
