{
  "rows": 20,
  "cols": 15,
  "ballSpeed": 6.0,
  "paddleWidth": 100,
  "brickWidth": 52,
  "brickHeight": 25,
  "layout": [
    "-00000---00000-",
    "044440---044440",
    "022220---022220",
    "011110---011110",
    "-33333---33333-",
    "--3333---3333--",
    "---333---333---",
    "----22---22----",
    "---022---220---",
    "--0222---2220--",
    "-02222---22220-",
    "022222---222220",
    "-02222---22220-",
    "--0222---2220--",
    "---022---220---",
    "----22---22----",
    "---033---330---",
    "--0333---3330--",
    "-03333---33330-",
    "000000---000000"
  ]
}