{
  "rows": 20,
  "cols": 20,
  "ballSpeed": 6.0,
  "paddleWidth": 100,
  "brickWidth": 39,
  "brickHeight": 25,
  "layout": [
    "--------------------",
    "-----------4--------",
    "---------4444-------",
    "-------444444-------",
    "-----0444344400-----",
    "----001322100001----",
    "---00113210000132---",
    "--0013120000003120--",
    "-001311000000131000-",
    "00131131000013110001",
    "-001311000000131000-",
    "--0013120000003120--",
    "---00113210000132---",
    "----001322100001----",
    "-----0444344400-----",
    "-------444444-------",
    "---------4444-------",
    "-----------4--------",
    "--------------------",
    "--------------------"
  ]
}