{
  "rows": 7,
  "cols": 12,
  "ballSpeed": 6.0,
  "paddleWidth": 100,
  "layout": [
    "141114411141",
    "141131131141",
    "111223321111",
    "144132231441",
    "132222222231",
    "111444444111",
    "232223322232"
  ]
}
