{
  "rows": 20,
  "cols": 26,
  "ballSpeed": 6.0,
  "paddleWidth": 100,
  "brickWidth": 30,
  "brickHeight": 25,
  "layout": [
  "--------------------------",
  "--1111111111111111111111--",
  "--11------------------11--",
  "--11------------------11--",
  "--11--11111111111111--11--",
  "--11--1122----22--11--11--",
  "--11--1122----23--11--11--",
  "--11--1111111111--11--11--",
  "--11--------------11--11--",
  "--11--------------11--11--",
  "--111111111111111111--11--",
  "----------------------11--",
  "----------------------11--",
  "111111111111111111111111--",
  "--------------------------",
  "--------------------------",
  "--111111111111111111111111",
  "--------------------------",
  "--------------------------",
  "111111111111111111111111--"
  ]
}