{
  "rows": 20,
  "cols": 26,
  "ballSpeed": 6.0,
  "paddleWidth": 100,
  "brickWidth": 30,
  "brickHeight": 25,
  "layout": [
    "---------1111111----------",
    "-----------111------------",
    "-----------111------------",
    "-----------111------------",
    "-----------111------------",
    "-----------111------------",
    "-----------111------------",
    "---------1111111----------",
    "------1111111111111-------",
    "----11122222222222111-----",
    "---111-------------111----",
    "---111-------------111----",
    "----111-----------111-----",
    "----11122222222222111-----",
    "111---0000000000000----111",
    "--------------------------",
    "--------------------------",
    "--------------------------",
    "--------------------------",
    "--------------------------"
    ]
}