{
  "rows": 20,
  "cols": 12,
  "ballSpeed": 6.0,
  "paddleWidth": 100,
  "brickWidth": 65,
  "brickHeight": 25,
  "layout": [
    "------------",
    "------------",
    "------------",
    "------------",
    "------------",
    "------------",
    "--02222220--",
    "--31111113--",
    "--04444440--",
    "------------",
    "------------",
    "------------",
    "------------",
    "------------",
    "------------",
    "------------",
    "------------",
    "------------",
    "------------",
    "------------"
  ]
}
