{
  "rows": 20,
  "cols": 12,
  "ballSpeed": 6.0,
  "paddleWidth": 100,
  "brickWidth": 65,
  "brickHeight": 25,
  "layout": [
    "-------------",
    "-------------",
    "------0------",
    "-----222-----",
    "----21112----",
    "---2244422---",
    "--222323222--",
    "-22322222322-",
    "2222222222222",
    "00---000---00",
    "111311-113111",
    "11111---11111",
    "1311-----1131",
    "111-------111",
    "11----0----11",
    "-------------",
    "-------------",
    "-------------",
    "-------------",
    "-------------"
  ]
}